# # # # # # # P # # # # # # # # # # # # # # # # # # # # # # # # # # # # # # # # # # # # # # # # # # 
# - - - - - - - - - - - - - - - - - - - - - - - - - - - - - - - - - - - - - - - - - - - - - - - - #
# - - - - - - - - - - # # - - # - - - - # - # - - - # - - - # # - - - - # - # - - - - - - # - - - # 
# - - - - - - - - - - - - - # - - # - - # - - - - - # # - - - - - - - - # - # - - - - # # - - - - # 
# - # - - - # - - # - - # - - - - - - # - # - - # - - - - - # - # - - - # - - - - - - - - - - - - # 
# # - - - - # - - - - - - - # - - - - - - - # - - # - # - - - - # # - # - - - - - - - # - - - - - # 
# # # - - # - # - - - - - # - - - # - - - - - - # - - # - - - # # - - - - # - # # # - - - # # - # # 
# - - - - # - - - - # - - # - - - - - - # - - - - # # - # - - - # - - - - # - - - - - - - # # # - # 
# - - # - - - - # - # - - - - - - - - # - - - - - - - - - - - - - - # - - # - # - # - # # - - - - # 
# # - # - - - - - - - - # - # - # - - # # - - - # - - # - # - # - # # - # - - - - # - - - # - # - # 
# - - - # # - - - - - - - - # - - - - - - - - - - - - - - - - - - # - - - - - # - - # - # - - # - # 
# - - - - - - - - - # - - # - - - - - - # - - - # - - - - # - - - - - - - - - - # - - - - # - - - # 
# - # - - - - - - - # # # - - - - - - # # - - - - - - - - - - - # - - - - - - # - # # - - # - - - # 
# # - - # - - - # - - # - - - # - - - - - - - - - - - # - - - - - - - - # - - - # - - - - - - - # # 
# # - - - - - - # - - # # # # - - - - - - - - - - # - - - - - # - # - - - - - - - - # - - # - # - # 
# # - - - - # - - - # - # - - - - # - - - # - # # # - - - - # - - # - - - - - # - # - - - - - - - # 
# - - - - - - - - - - # - - - - - # - - - - - # - # # - # - - - - - - - - - - - - # - - - # # - - # 
# - - # # - # - # - - # - - - - - # - - - - - - - - - - - - # - # # # # - - - - - - - - - - # # - # 
# - - - # - - - - # - - # - - - - - - - - - - - - - # # - # - # # # # - - - - - # - - - # - - - - # 
# - - - - - - - - - - # - - - - - - - # - - - - - - - - - - - - - - - # - # - # - - - - - - - - - # 
# - - - - - # - # - - # # - # - - # - # - - - - - - - - # # - # - - - - - - - # - - - - - - # # - # 
# # - - - - - - # # - - - - - # - # # - - # - - - # - # - - - - - # # - - - - - - - - - - - - - - # 
# # - - - - # - # - - - - - - - - - - - - - # - # - - - # - - - # - # - - - - - - - - - # - - # # # 
# - # - - - # - - # - - - - - - - - # - - # - # # # - - - - - # - # - - - - - - - # - - - - - - - # 
# - - - - - - - - - # - - # - - - - - - - - - # - - - - # - - - - - - # - - - - - # # - - - - - - # 
# # - # - - - # # - - # - # - - - # # - - # # - - - - - # - - # - - - - # # # - - # # - - - - # - # 
# - - - - - - # - - - - - - # - # - - - # - - - - - # - - # # # - - - # - - - - - - - - - # # # - # 
# - - - - - - - # - - - - - - - - - - - - - - - - - - - # - - - # - # - - # - - - - # - - - # - - # 
# # # - - - - # - # - # # - - - - # # - - - - - - - - - - - - - - - - # - - - - - - # - # - - - - # 
# - # # - - - - - # - - - - - - - - - - - - # - - - # - # - - - - - - - - - - - - - - - # - - - - # 
# - - - - - - # - - - - - - # - # - - - - - - - - - - # # # - - - - - - - - - - # # # - - - - # # # 
# - - - - # - # # - - - - # - - - - - - - - - # # - # - - - # - - - - # - - - - - - - - # - - - - # 
# - - - - - # - - - - - # - - - - - - - - - # # - - - - - # - # - - - - - - - - # - - - # # - - - # 
# - - - - - - - # # # - # - # # - - - - - - - # - - - - - - - - - # # - - - - # - # # - - - - # # # 
# - - - # - - - # - # - # - - - # - - - - - # # - - - - - - - # - - - # - - - # - - # - - - - # - # 
# - - # - - - - - - - - - - - - - # - - - - # - # - - - - # - # - - - - - - # - - - - - - - - - # # 
# # - - - - - - - # # - - - - - - - # - # - - - # - - - # - # - - - - - - - - - - - - - - - - - - # 
# - # - - - # - - - # - # - - - # - - # - - - - - - # - - - - # # - - - # - - - - - - - - - # # - # 
# - - - - - - - - - - - - # - # - # # - # - # - - # # - - - - - - # - - - - - # - - - - - - - - - # 
# - - - - - - # # - - - - # - - - - # # # # - # - - - # # - - # - - - - - - - - - - - - - - - # # # 
# # - - - - - - - - # - - - - # # - - # - # - # # - - - # - - - # - # - - - - - - - - # - - - - - # 
# - - - - - - - - - # - - - - - - - # - - - - - - - - - # # - - - - - - - - # - # - - - - - - - # # 
# - - - # - - - - - - - - - # - # - - - # - - - # - - - - - # - - - - - - - - - - - - # # - - - - # 
# - # # - - - - # - - - - # # # # - - - - # # - - - - - - - - - - # # - - - - - # - # - - - # - # # 
# - - - - # # - - - # - - # - - - - - # - - - - - - - - # - - - # - - - - - - - - - - - - - - - - # 
# - - - - - - - - - - - - # # - - - - - - # # # # - - - - - - - - - # - - # # - # - # - - - # - - # 
# - - # - - - - - - - - - - - - - - # # # - - - # - - - - # # - - # # - - - # # - - # - - - # - - # 
# # - - - # # - # # # - - - - # - - # - - - # # - - # # - - - # - - - # - - - - - - # - # - # - - # 
# - - - - - - - - - - - - - - - - - - - - - - - - - - - - - - - - - - - - - - - - - - - - - - - - #
# # # # # # # # # # # # # # # # # # # # # # # # # # # # # # # # # # # # # # # # # F # # # # # # # # 
