P # # # # # # # # # # # # # # 
# # # - # - - - - - # - # - # 
# # - - - - - - - - - - - - # 
# - # - - - - - - - - - # - # 
# - - - # - - - - - - - - - # 
# - # - - - - - - - - - - - # 
# - - - - # - - - - - - - - # 
# - - - # - - # - # - - - - # 
# - # - - - - - # # - - - # # 
# - # - - - - # # - - - - # # 
# - # - - - - - - - - - - # # 
# # - - - - - - - - - - - # # 
# # - # - # - - - - - - - # # 
# - - - - - - - - - - - - - # 
# # # - - - - # - - # - - - # 
# - # # - - - - - - - - - - # 
# - - - - - - # # - - - - - # 
# - - - - - # - - - - - - # # 
# - - - - - # - - - - # - - # 
# # # # # # # # # F # # # # # 

