# # # # # # # # P # # J # # # 
# - - - - - - - - - - - - - #
# - - - - - - - # - - - - # # 
# # - # - - - - # - - - - - # 
# # # - # - - - - - - # - - # 
# - - - - - # - - - # # - - # 
# - # - - - - # - # # - - - # 
# - - - # - - - # - - - - - # 
# - - - - - - - - - - # - - # 
# # # - - - - - - - - # - - # 
# - - - # # - - - # - # - - # 
# # - - - - - - # - - - - - # 
# - - - - - - - - # - - - - # 
# - - - - - - - - - - - - - #
# # # F # # # # # # # # # # # 
