# # P # # # # # # # # # # # 
# - - - - - - - - # - # - # 
# - - - - - - - - - # - - # 
# - - # - - - - - - - - - # 
# # - - - - - - - - - - - # 
# # - - # - - - # - - - - # 
# - - # - - - - - - - - - # 
# - - - - - - - # - - - # # 
# - # - - - - - - - - - - # 
# - - - - - # # # - - - - # 
# - - - - - - - - - - - - # 
# - - - - - - - - - - - - # 
# - - - - - - - - # - - - # 
# # - - - - # - - - - - - # 
# # # # # # # # # # # # # F 
