# # P # # # # # J # # # # 
# - - - - - - - - - - - #
# - # # - # - - - # - # # 
# # # # - - # - - - # - # 
# - # - # - - - - # - # # 
# - # - - - # - - - # # # 
# - - - - # # - - - - - # 
# - - - # - - # - - - - # 
# - - - - # - - - # - - # 
# - - - - - - # - # # - # 
# - - - # - - - - # - # # 
# - - - - - - - - - - - #
# # # # F # # # # # # # # 
