# # # P # # # # # J # # # 
# - - - - - - - - - - - #
# # - - - - - - # - - - # 
# - - - - - - # # - - - # 
# # - - - - - - - - - - # 
# - - - - - # - - # - - # 
# - - - # # - - - - - # # 
# - # - - - - - - - - - # 
# - # - - # # - - # # - # 
# - - - - - - - - - - - # 
# - # - - - - - - - # - # 
# - - - - - - - - - - - #
# # # F # # # # # # # # # 
