# # P # J # # # # # 
# - - - - - - - - #
# - - # - # - - - # 
# - # - - - - - - # 
# - - - - - - - - # 
# - - - # - - - # # 
# - - - - - - - - # 
# - - - - - - - - # 
# - - - - - - - - #
# # # # # # # # F # 
