# # # # # # # # # P # # J # 
# - - - - - - - - - - - - #
# - - # - # # - # # # - - # 
# # # - - - - - - # # - - # 
# # - - - # - # # - - - # # 
# - - # - - - - - # # # - # 
# - - - # - # - - - - # # # 
# # - - - - - - # # # - - # 
# - - - - - - - - - # # # # 
# - # # - - - - # - - # - # 
# - - - - - - - - - - - - #
# # # # # F # # # # # # # # 
