# # # # # # # # # # # # P # # # # # # # # # # # # 
# - - - - - - - - - - - - - - - - - - - - - - - #
# - # - - - - - - - - - - - - - # - - # - - - - # 
# # - # - - - # - - - - - - - - - - - - # - - - # 
# - - - - - - - - - - - - - - - - # - - # - - - # 
# - - # - - - - - - - - # - - - - - - # - - - - # 
# - - # - - # - - # - - - # - - - - - - - - - - # 
# - # - # - # - - - - - - - - - - - - - # - - - # 
# # - - - - # # # - # # - - - # # - - - - - - - # 
# - # - - - - # # # - # - - # - - - - - - - - - # 
# - - - - - - - # - - - - - - - # - - - - - - - # 
# - - - - - - - # # - # - # - - - # - - - - - - # 
# - - - - - - - - - - - - - # # # # - - # - - - # 
# - - - - # - - - - - - # - # - # - # - # - - - # 
# - - - - - - - - - - - # - - - - - # - - - # - # 
# # - - - - - - - # - - - - - - - - - # - - - - # 
# # - # # # - - # - - - - - - - - - - - - - - - # 
# - - - - - - # - # - - - # # # - - - - - # - - # 
# - - - - - # # - - - - - - # # - - # - - # - - # 
# - - # # - # - - - - # - - # - - - - - - - - # # 
# - - - - - - - - - - - - - # - - # - - - - - - # 
# - - - - # - - - - - - - # - - - - - - # - - # # 
# - - - # # - - - - - - - - # # - - - - - - - # # 
# - - - - - - - - - - - - - - - - - - - - - - - #
# # # # # # # # # # # # # # # # # # # # # # F # # 
