# # # # # P # # # # # # J # # 
# - - - - - - - - - - - - - #
# - - - - - - # - # # - - - # 
# - - - - - - # - - - - - - # 
# - - - - - - - - - - - - - # 
# - - - - - - - # - - - # - # 
# - - # - - - # - # # # - - # 
# - - # - - - - - - - - - - # 
# - - # - - # - - - # - - - # 
# - # - - - # - # # - # - - # 
# - - # - # # - # - - # - - # 
# - - # # # - - - - # - - - # 
# - - # - - # - - - - # # # # 
# - - - - - - - - - - - - - #
# # # # # # # # # F # # # # # 
