# P # # # # # J # # 
# - - - - - - - - #
# - - - # - # - - # 
# - - # - - # # - # 
# - - # # # - - - # 
# - # - - - - # # # 
# # - # - - - # - # 
# # - - - # # - - # 
# - - - - - - - - #
# # # # # # # F # # 
