# # # # # P J # # # 
# - - - - - - - - #
# - - # - - - - - # 
# - - # - - - - - # 
# # - - - - - - - # 
# # - # - - - - # # 
# - - - - - - - - # 
# # - - - - - - # # 
# - - - - - - - - #
# # F # # # # # # # 
