# # # # # # # # # # # # # # # # # # # # # # # # # # # # # # # # # # # # # # P # # # # # # # # # # # # # # # # # # # # # # # # # # J # # # # # # # # # # # # # # 
# - - - - - - - - - - - - - - - - - - - - - - - - - - - - - - - - - - - - - - - - - - - - - - - - - - - - - - - - - - - - - - - - - - - - - - - - - - - - - - #
# - - - - - - # # - - - # - # # - - - - - - - - - - - - # - - - # # - - - - # # # - - - - - - - # - - - # # - - # # # # # - # - - - - - - # - - - - - - - # - # 
# # - - # - - - - - - # - - - - - - - - - # - - # - - - - - - - - # # - # - - - - # - - # - # - - - - - - - - - # # # - - - - - - - - # - - - - # # - # - - - # 
# - - # - # - - - # - # - # - - - - - - - - # - - - # - # - - - - - - # - # - # - - - - - # - # # - - - - - - - - - - # # # # - # - # - # - - # - # - # - - # # 
# - - - - - - - # - # # - # - - # - - # - - - - - # # - - - - - # - - - - # - # - - - - # - - - - - - - - - - - - - - # - # - - - - - - # - - - - - - # # - - # 
# - - - - # - - - - - - - - # - - # # # - - # # - - # - - - # - - - - - - - - - - - - - # - - - - - # - - # - - - - - - - - - - - # - # - - - - - - # - - - - # 
# - - - - - # - - # # - - - - - - - - - - - - - # - - - - - - - - - - - # - - # - - - - # # - - - - - - - - - - - - - - - - - # # - - - - # # - # - - # # - # # 
# - - - - - - - - - # - # - # - - - - - # - - - - - - - - # - - - - - # - - # - - - - - - # - # - - - - - - # # - - - - - - # - - - - - - # - - - - # # - # - # 
# # # - - # - - # - - # - - - - - - # - - - - - - # - # # - - # # - - - - - - - - # # - - # - # - - # - - # - - - - - - # - - - - # - - - - - - - - - - - - - # 
# - - # - # - - - - - - # - # - # - - - - # - - - # - # - # # - # - - - - - # - - # - - # # - # - - - - - - - - - - - - - - - - - - # - - - - - - - - - - # # # 
# - - - - - - # - - # - - - # - # - - # - # - - - - - - # - # - - - - - # - # - - - - - # - - - - - # - - - - - # # - - - - - - # # - - - - - - # - - - - - - # 
# - # # - # - - - - - - - - - # - - - - - - - - - - # - - - - - # - - # - - - # - - - # - - - - # # # # # - - - - - - - - - - # - - - - - - - - - - - # # - - # 
# - # # - # - # - - - - - # - - - - - - # - - - - # - # - - # - - - # - # - - # # - - - # # - - - - - - # - - - - - - - - - - - # - - - - - - - - # - - - - # # 
# - - - # - - - - # - - # - - - # - - - - - - # # - - - - - - - - # # # - # - # # - - - - - - - - - - - - - - - - - - # # - # - - - - - - # # - - - - - - - - # 
# - # - - - - - - # - - - - - # - - - - - - - - # - - # - - # - - - - - - - - - # - - # - - - - - - - - - - # - # - - # - # - - # - - - # - - - - - - - - # - # 
# # - - - - - # - - - - - - - - # - - - - - # - # - - - - - - # - # # - - - # - # - # - - - # # - - # # - # - - - # - # # # - - - # - - - - - - - - # # - # - # 
# # - - # - - # # # - - - - # - # - - - - # - - - - - - - - - - - # - - - # - - # # - - # - # - # - - - - - # - - - - - # - - - - - - - - # - - # - - # - - - # 
# - - - - - - - - - - # - # - - - - - - - # - - - # # - - # - - - - # - - - - # - - - - - - - - - - - - # - - - - - - - # - - - # # # - - # - # # - - - - - - # 
# # - - - - # # - - - # # - - - - - - - # - - - - - - - - - # - - - - - - # - - - # - - - - - # # - - - - - - - # - # - - - - - - - # - - # - - - - # - - - - # 
# - - - - - # - - - # - - # - - # - # - - - - # - # - - - - # - # - - - - - - - - - - - - # # - - - - - - - - - # - - - - # - # - # # # - - - - # # # - - # # # 
# - - - - - - - - - - - - - - # # - - # - # - # - # - # - - # - # - - - - # - - - - # - - - # - # - - - - - - - - - - - - - - - - - - # - - - - - - - - - - - # 
# # # - - - - # - - - - - - - - - - - # - - - - - - # - - - - - - - - - - - - - - # # - # # - - # # - - - - - # - - - - - # - - - # - - - - - - - - # - - - - # 
# - - - - - - - # # - # # - - - - - - - - - - # # - - - # - - - # # - - # - - - - - # - - # - - - - - - # - - # - - - - - - - - - # - # # - - - - - # - # - - # 
# - - - - # - - - - - - - - - # - # - - - - - - - - # - # # - - - - - - - - - - - - - - # - # - - - - - - - - - # - - - - - - - - - - - - - # - - - - - - - - # 
# # # # - # - - - # - - - # - - - # - - - # - - - - - - - - - - - - - - - - - # - - - - - - - # # - # - - - - - - - # - # - - - # - - - - # - # - # - # # - # # 
# - - - # # - - - - - - - # - - - - - # - - - - - - - - - - - - - - - - - - # - - - - - # - - - - # - - - - - - - # - # # # - - - - - - - - # - # - - - - # # # 
# # - - - - - # - - - - - - - - - - - # - - - - - - - - - - - - - - - - - # - - - - # - - - - # # - - # # - # - - - - # - - - - - - - - - - - - - - - - - # - # 
# - # - - - - - - # # - - # - # - # - - # # - - - - # - - - - - # - - - # - # - - - - # - - - - - - # - - - - - - # - - # - - - - # # - - - - - - # - - - - - # 
# - - - - # - - - # # - - - - - - - - # - - - - - - - - # - # # - - - - - - - - # # - - # - - - - - # - - - - - # - - # - - - - - - - - - - - - - - - - - - - # 
# - # - - - - - # # # # # # - - - # - # # - - # # - - - - - - - - # # - # - - - - - - - # - - - - - - - - # - - - - # - - - # - - # - - # - # - - # - - - - # # 
# - - - # - # - - - - # - - - - - - # - - - - - - - - - - - # - - - - - - # - # - - - - - - - - - - - - - - - - - # - # - - # - # - - # - # - - - # - - - - # # 
# - - # - - # - - # - - - # - - - - - - # - - # - - # - - - - - # - - # - - - - # - - - - - # - # # - - # - - - - - # - - - - # - - # - - - # - - - - - - - - # 
# # - - - - # - - # - # - # - - - - - - - - - - - - # # - - - - - # - # - - - # - # - - - - - - - # - - - - - - # - - - - - - # - - # - - - - - - - # - - - - # 
# - - - - - - # - - - - - - - - - - - # - - - - - - - - - - - - - # - - - # - - - - # - - # - # # - - # # - - - # - # - # - - - - - # # - - - - - - - - - - - # 
# - - - - - - - - # - - - - - - - - # - - - - - - - - - - - # - # - - - - - - # - - - - # - - - - - - - # - - - # # - - - - - - - - - # - - - - - - - - - - - # 
# - - - - - - - - - - - - - - - - - - - # - - - - - - - - - - - - - - - - - - - # - - - - # - - - - - - - - - - - # - - - - - - - - # - # - - # - - # - # - # # 
# - - - - - - - # - # # - - - - # - - - # - # # - - - - - - - - - # - - # - - - - - - - - - - - - - # - - # - - - - # # - - - # - # - # - - - - # - # - - - # # 
# - - - # # - - - # - - - # - # - - - - - - - - # - - - # - # - - - - - - - - - - - # - - - - # # - - # - - - - - - - - - # - - - - - - - - - - - - - - # # - # 
# - - - # # - - - - - - - - - - - - - - # - - - - - # - - - # - - - - - - # - - - - - - - - - - - - - - - - # - - - - # - - # - - - - - - - # # - # - - - - - # 
# - # - - # - # - # # - - - - - # # - - - - - # - # - # - - - - # - - - - - - - - # - # - # # - - - - - - - - - - - - # - # - - - - # - # - # - - - # - # - - # 
# # - # - - - - # - - - # - - - # - - - - - - - - - # # - # - - - # - - - - - - - - - - - - # - - - - - - - - - - - # # - - - - - - - - # - # - # - # - - - - # 
# - - - - - - - - - - - # - - # - - - - - - - # - - # - - - - - - # # - # # - - - - - # - - # - - - - - # - - - # - - # - - - - - - - - # # - # - - - - # - - # 
# - # - - # # - - - - - - # - - - - - - - - - - - - # - - - - # - - - - # - - - - - - - - - - # - # - - - - - - - - - - - - - - # - # - - - - - - - # # - - - # 
# - - - - - - - - # - - - - - # - - - - # - - - - # - - # - - # - - - # - - - - - # # - # - - - # - - - # - - # - - - - - - - - - - - - - # - # - - # # - - - # 
# # - - # - - # - # - - - - - # - # - # - - # - # - - - - - - - - - - - - # # - - - - - - - - - - - # - - # - # - # # # - # # - # - - - - - - - - - - # - - - # 
# - - - - - - # - - # - - - - - - - - - - - - - # # - # - - - - - - - - - - - - - - - # - - - - - - # # - - - - - - - - # - - - - - - - - - - # - # - # - - - # 
# - # - - - - - - - - - - # - # # - - - # - - # # # - - - - - - - - - - - - - - - - # - - - # - - - # - - - - - - - - - # - # - # - - - - - - # - - # # - - # # 
# - - - - - - # - - - - - - - - - - - - # - - - - - # - - - - # # - - # - # # - - - - - - - - - # - - # - # - - - # - # - - - # - - # - # - # - # - - - - - # # 
# - - - # - - # # - - - - # - - - # - - - - - # - - # - - - - # - - - - - - - - - - - - - - - - # - - - - - - - - # - - - - # - - - - - - - - # - # - - - - - # 
# # # - - - # - - - - - - - - - - # - - - - - # - - - - - - # - - - - - - - - - - - - - - - - - - - - - - # - - - # - - - - - - - - - - - - - - - - # - - - - # 
# # - # # # # - - - - # - - - - - - - - # - - - - - - - - - - - - - - - - - - - # - # - - - - # - - - - - - - # # - # - - - - - # - - - - # - # - - - - - # - # 
# - - - # - # # - # - - - - - # - - - # # # - # - - - - - # - - - # - - - - # - - - - - - # - - # # # - - - - # - - # - - # - # - - # - - # - # - - # - # # - # 
# # - - - - # - - - - # - - - - - - - - - - - - # - - - - - - # - - - - # # # - - - - - # - - - - # - # - - - - - - # - - - - # - # # - - # - # # - - - - # - # 
# - - - # - - - - - - - - - # - - # - - - - - - - - # - # - - - - # # - - - # - - - - - # - - - - - - # - - - - - # - - - - - # - - # - - - - # - # - - - - - # 
# # - # # - - # - - - - - - - # - # - - - - - - - # - - # - - # - - - - - - - - # - - # - - # - # - - - - - - - # - # - - - - - - - # # # - - - # # # - - - - # 
# - # - - - # - - # # - - # - - - - - - - - - - - - - - - - # # # # - - - - - - - - - - - # # - # - - - # # - - - - - - - - - - - - - - - - - - - - - - - - - # 
# # - - - - - - - # - - - - - # - - - - - - - # - - - - - - # - - - - - - - # - - - - # - - - # - - - - - - - - - - - - - - - - - # - - # # - - # - - - - # # # 
# - - - - # - - # - # - - - - - # - - # - # # - - # - # # # - # - - - # - - - - # # - # # # - # - - - - - - - - - - - - # - - - # - - # - - - - - - # # - # - # 
# # - - - - - - - - - - - - # # - # - - - - # - - - - - - - - - # - # # # # # - - # - - - # # - # - - # - - - - - - - - - - - - - # - - - # - - - # - - - - # # 
# - - - - - - - - # - - # - - - - - - - - # - - - - - - - - - - # - - - - - - - - # - - # - - - - - - - - - # - - # - - - - - - - - # - - # - # - - - - - - - # 
# # # # - - - - - # - - - # # - - # # - # - - - # - - # - - - - - - - - - - - - - - # # - - - - # - # - - # - # - - - - - - - - - # - # - - - - - - - - - - - # 
# - - - - - - - - - - - # - - - - - - - - - - - - - - - - - - # - - # - - - - - - - - - - - - - - # - # # - # - - - # - - - - - - # - # - # - - - - - - - - - # 
# - - - - - - # # - - # - - # - - # # - - - - - - - - - - - # - - - # - - - - - # # # # - - - - - - - - - - # # - - # - - - - - - - - - # - - - - - - # - # # # 
# - - - # # - - - - - - - # - # - - - - - # - # - - # - - - # # - - - # - - - - # # - - - # - # # # - - - - - - # - - - - - - - - - - - - - - # - - - - - - - # 
# - - - # - - - - - - - - # - - - - - - - # - - - - - - - - - # - # # - # - - - - # # # - # - - - - # - - - - - - - # - - - - # - - - - - # # # - - - # - - - # 
# - - - - # - - - - - - - - - - - # - - # # - - # - # - # # - - - # - - - - - - - - - - - - - # - # - # - - - - # - # - # # - # # - - - # - - - - # - - # - - # 
# # # - - - - # - - # - - - - - - # - # - - - - - - - - # - - - - # # # # - - - - # - - - - # - # - - - # - - - - - # - - - - - - # - - - - - - - # - # - - # # 
# - # - # - # - - # - # # - - - - - # # - - # # # - - - # - - - - - - - - # - - - # - - - # - # - - # - - - - - - - - - - # - - - - - - # - # # # - - - - # # # 
# - - - - - - - # - - - # - - - - - # - - - # - # - # - - - # - - - - # # # - # - - - - - # # # - - - - - - - - # - # - - - - - - - - - - - - - - # # # - - - # 
# - - # - - - - - - - # - - - - - - - # # - # - - - - - # - # - - - - - - # - - - - - # - - - - - - - - - - - - - - - - - - - - - # - - # - - - - # - - - - # # 
# # - - - # # - - - - - - - - - # # # - # - - - - - - - - - - - # - # - - - - # # - - - - - # - - - # - - - - # - - - - - - - - - - # - # - # - - - - - - - # # 
# - - - - # - - # # # - - - # - - - - - - - # # - - - - - # - - - - - - # - # # - # - - - - - - - - # - - - - - - - # - - - - - - - # - - - - - - - - # - - # # 
# - - - - - - - - - # - # - - - - - - - - - - - # # - # - # - - - - - - # - - - - - - - - - - - - - - - - - - - - # - - # - - - # # - - - - - # # # - - - - - # 
# - # # - - # - - # - - - - # # # # - - - # # # - - - - # - - # # - - - # # - - - - - - - - - # - - - - - - - - # - - - - - - - - - # - - - - - - # - - - - - # 
# - - # - # # # - - - # - - - - # - - # - - - # - - # - - - - - - # - # - - # - - - - - # - - - - - - - - # - - - # - # # - - # - - # - # - - - # - - # - - - # 
# - - - - # - # - - - - # - - - - - - - - - - - - # - - - - - - - - - - - - - - # - - - - - - - - - - # - - - # # - - - - - - # - - - - # - - # - - # # - - - # 
# # - # - # - - - - - - - - - # - # - - - - # # - - # - - - - # - - # - # - - # # - - # - - - - - - - - # # - - - # - - # # - - # - - - - - - - - - - - - - # # 
# - - - - - - - - - - - - - - - - - - - - - - - - - - - - - - - - - - - - - - - - - - - - - - - - - - - - - - - - - - - - - - - - - - - - - - - - - - - - - - #
# # # # # # # # # # # # # # # # # # # # # # # # # # # # # # # # # # # # # # # # # # # # # # # # F # # # # # # # # # # # # # # # # # # # # # # # # # # # # # # # 
