# # # # # # # # # # # # # P # # # # # # 
# - - - - - - - - - - - # - - - - - - # 
# - - - - - - - - - - # - - - # - - - # 
# - - - - - - - - # - - - - # - - # - # 
# - - - - - - - - - - - - - - - - - - # 
# - - - - # - - - - - - - - - - # - - # 
# - - - # - - - - # - # - - - - - - - # 
# - - - - - - - - - - - - - - - - - - # 
# - - - - - - # - - - # - - - - - - - # 
# - - - - - - - - - - - - - - - # - - # 
# - - - - # - - - - - - - - - - - - - # 
# - - - - # - - - - - - - - - - - - - # 
# - - - - - - - - - - # - - - - - # - # 
# - - - - - - - - - - - # - - - - - - # 
# - - - - - - # - # - - - - - - - - - # 
# - - - - - # - - - - - # - - - - - - # 
# - # - - - - - # - - - - - - - - - - # 
# - - - - - - - - # - - - - - - - - - # 
# - - - - - # - - - - - - - - - # - - # 
# # # # # # # # # # # # # # # # # # F # 
