# # # # # # # # P # 
# - # - - - - - - # 
# # - - - - - - - # 
# - - - - # - - - # 
# - - - - - - - - # 
# - - # - - - - - # 
# - - - # - - - - # 
# - - - - - - - - # 
# - - # - - - - - # 
# # # # # F # # # # 
