# # # P # # J # # # 
# - - - - - - - - #
# - # - - - - - - # 
# - - # - # - - - # 
# - - - - # # # - # 
# - - - - # - # - # 
# - - - # - - - - # 
# - - - - # # - - # 
# - - - - - - - - #
# # # # # # # # F # 
