# # # # # # # # # # # # P J # # 
# - - - - - - - - - - - - - - #
# - - - - - - - - - - # # - # # 
# # # - - - - - - - - - - - - # 
# - - - # - - - - - # - - # - # 
# - - - - - - - - - - # - - - # 
# - - - # - - - - - - - - # - # 
# # - - - - - - # - - - # # # # 
# - - - # - - - - - - - - - - # 
# - - - - - - - - - - - # - - # 
# - - - - - - - - - - - # - # # 
# - - - - - - # - - - - - # # # 
# - - - - - - - # - - - - # - # 
# # # - - # - - # # - - - - - # 
# - - - - - - - - - - - - - - #
# # # # # F # # # # # # # # # # 
